...........................................................
...........................................................
...........................................................
...........................................................
...........................................................
...........................................................
..................####.....................................
...........................................................
..@.....#######........................................D...
###########################################################